15 15
###############
#$           $#
#   #     #   #
#   #     #   #
#   #  $  #   #
#   #     #   #
#   #     #   #
#      &      #
#   #     #   #
#   #     #   #
#   #  $  #   #
#   #     #   #
#   #     #   #
#$           $#
###############
